11111111111111111111
10000000010000001001
10000000010000001301
10000000001110001001
10000000001300001001
10400404001110021001
13000000000000000001
11111100000000000001
10000000000000000001
10000000000000000001
10000000000000000001
10000000000000000001
10000000000000000001
10444000030000111111
11010000000000100001
13000000000000100301
10000000000000100001
10000000000000000001
10000000000000000001
11111111111111111111